#####################################################################################################
#             # #   # #     # # # #   #   #   #           #   # #       #   # # #       # #         #
### ##### ### # ### # # ### # # # # # ### ### ### ####### # ### # # ##### # # # ### ### # # ### # ###
# #   #   # #     #   #   #   #     #   # # # # #     #         # # # #   # #       # #   #   # #   #
# # ##### # ### ##### # ####### ####### # # # # # ##### ####### # # # # ##### # ##### # ### ##### # #
#       #   # # #     #       # # #   #     #     #       #     # #     #     #   #   # #       # # #
# ### ####### ##### # # ### # # # # ######### ######### ##### # # ### ### ### # ### # ### # #########
#   #     #       # # # # # #   #     #     #     #   #   #   # # # #     # # #     # #   #   # #   #
# # ########### ### ### # # ### # ######### ##### # # # ########### # ##### ######### ####### # # # #
# # # # #     #     # # #   #   # #       #       # # #   # #     #   #     # #     #   # #   # # # #
### # # ##### # # ### # ##### # # ### # ### ### # ### ##### # # # ### # ##### # ##### # # ### # # # #
#       #       #   # #     # # # #   #       # # #     # # # # #   #         #       #   # #     # #
### ##### ########### ##### ##### ##### ### # ##### # ### # ##### ### ### # ##### ####### # ### #####
# #                   #     #     #   # #   #       #     #         #   # # # #         #       #   #
# # ### ########### ##### # # # # ### # # ### ### ####### # # ##### ### ### # ### ##### ######### ###
#     #   #       #       #   # #     # #   # #       # # # # #   #       #     # #   #   #         #
##### ### # ##### ### # ##### ####### # ##### # # ### # # ### # # # ### # # # ### ### # ####### #####
#       #   # # #   # #   #     #           # # #   #   #     # #     # # # # #   #       #     # # #
# ########### # ##### ### # ### ##### # ### ### # ######### # ####### ### ####### ####### ##### # # #
# #       #   #   #   #   #   # #     #   # #   # # #       #     #   # #     #         #   # #   # #
# # ### ### # # # ### ##### ##### # ##### ##### # # # ############# # # ####### # ##### ##### # # # #
#     #     #   # #   #       # # #     #   #   # # # # #       #   # #   # #   #     # #   #   #   #
### # ##### ### ### ### ##### # # ####### # ### ### ### ##### # ##### # ### ### ######### ##### #####
# # # #     #     #   # # #     #       # # # #     # #   #   #           #   #   #   #   # #       #
# # ########### ##### # # # ##### ########### ##### # # ####### # # # ####### # ### ### ### ##### # #
# #     #         # # # # # #     #     #       #             # # # #   # #   #   # # # # #   #   # #
# ### ### # # # ### # # # # ####### # ### ##### ##### # # ### ########### # ####### # # # # # ##### #
# #     # # # #     # # # # # # # # #   #     #   # # # #   #   # #   # # # #     #       # #     # #
# # # ##### ##### ### ### # # # # ##### ### ####### ### ### # ### ### # # # ### ####### # ### ### # #
#   #     #     #   # #   #       #   #   # #       #   # # #   #   #   #     #   #   # # # # # #   #
# # ### ##### # ### ##### # # ####### ### # # ####### ### ##### ### # ####### # # # # ### # # # ### #
# #   # # # # #   #     #   #     #   #   #   # # #     # #   #   # #   #     # #   # # #       # # #
### # ### # ########### ### ##### # ##### # # # # ### ### # # ##### # # ### ### ### ### # # ##### ###
#   #       #     #       #     # # #     # #     # # #     #         # #     # #   # # # # #     # #
# ### ######### ########### ### ### ### ##### # ### # ##### ##### ##### ##### # # ### # ### ##### # #
# # # #       #   #     # # #   # #   # #     # #   #   # #     # #           # #     #             #
# # # # ##### # # ### # # ##### # ### # # ### ##### # ### # ##### # ##### # ### ### ##### ### ##### #
#   # #     #   # #   #   #         #     #   #   #   # #   #   # #   #   # #   #       #   #     # #
# # # ### ##### # # ####### # ######### ####### # # # # ### ### # ##### ### ##### # # # ### # # # ###
# # #         # # #       # # #     # #   #   # #   #   #     #   #     # #       # # #   # # # #   #
### # ### ####### # ### ##### # ##### ### ### # ### ### ################# # ####### ### ### ### ### #
#   # #   #   #     # # # #       #       #   # #   #         #     # #     #   #   # # #     #   # #
# ### # ### ### ### # # # # ### # ### ####### ############# ##### ### # ####### # ### ##### ##### ###
#   # #   #     #   #   #     # # # #     # # #   #       # # #         # # #     # #         #     #
# ####### ##### ### ######### # # # ### ### # # # ### # ### # # ####### # # ##### # # ### # ### #####
#     #   #   # #   #   #     # # # #   #     # # #   #   #   # #   #         # #     #   #   #     #
### ####### ##### # ### ##### # ### # ### ####### ### # # ### ##### ######### # # ### ### ######### #
#       # #       #         # # #       # #     #     # # # # #     #   #   # #   # #   # #   #     #
### ### # ##### ### ### # ### ### ####### ### # # # ##### # ####### # # # ### # ### # # ### #########
#   # #     # #   # #   #   #   #   #     # # # % #   #   #     #   # #     # #   #   #       # #   #
# ### ### # # ##### ##### ####### ### # # # # ##### # ##### ### # # ##### ##### ######### ### # # # #
# #       # # #     #   # #         # # #     #   # #   # # #     # # #     #     #   #   # #   # # #
### # # ##### # ####### # # ### ##### ##### ### # ### ### # ### ##### # # ### # ### ##### # ##### ###
#   # # #       #     #   # #   #   # # #     # # #   # #     #     #   # # # #       #   #     #   #
### # # ########### ### ####### ### # # ### # # # ### # # ##### ##### ##### ########### ### ### # ###
#   # # #   #       #   #   #         #   # # # # #     # # #     #   #             # #       #     #
# # ### # ### ### ### # ### ### # ### ### # # ### # ### ### ### ### ############### # ####### ### # #
# # # #     # # #   # # #     # # #   #     # #       # #   #     #   #     #       #   # #   #   # #
### # ##### # # ### # ### # ##### ### # ### ####### ##### # # ####### # ####### ### ### # ### ##### #
#         #   # #   #     #         # # # #   #   #     # # #   #     #     #   #     #     #   #   #
# ### ### # # # ####### ### ##### # ### # ### # ##### ##### # ##### ####### # ####### # ##### ##### #
# #     # # #       #     # # #   #   #     #   #       # #     #   #     #   #     #   #         # #
# # ######### # ### ### # # # # ########### ### # ### ### # ### # # # # # # ####### # # ##### #######
# # # #       # #   # # # # # # # # #     # # # # #         #     # # # # #     # #   #     #       #
# ### ##### # ### ### # # ### ### # ### # ### ######### # ##### # ### ##### ##### # ######### # #####
# #     #   # #     # # # #   # # # # # #     #   # # # # # #   #     # #     # #     #   # # #     #
# ### # ### ######### # ### ### # # # ##### ### ### # ### # ##### ### # # ##### ### # # ### # # ### #
# # # # #       #   #   # #   #           #     #           #   #   #           #   #   # #   # #   #
### ### # # ##### # ##### ### ##### ##### # ### ### ### ##### ### ####### ####### ####### ### # ### #
#       # # # # # #         #   #   #   # #   # #     #     #       #           #       # # # # #   #
##### ### ### # ### ##### ##### ### # ##### ######### # ### ######### ##### ############# # ##### # #
#     #     #   #   #   #   #                 # #     # # # #     # #     # # #     # #   #       # #
### # ### ##### # ### ### ############# # # # # ######### ##### ### ### # ### ### ### ### # # ### ###
# # #     # #   # #   #       # # # # # # # # # #     # # # #   #   # # # #       #     #   #   #   #
# # ### ### # ### # # # ##### # # # # # # ### # # ##### # # # # # ### ### # ##### ##### # # ### ### #
#   #       #   # # #   #     # #     # #   # #     #       # #   #   # #     #     # #   # # #   # #
### ### ### # # # ####### ### # # # ##### # ####### # ### ### ### ### # # ########### # ##### ### # #
#   # #   # # # # #     # #   #   #     # #   # # #   #     # #   #   #               #       #   # #
# ### ####### ##### # # ### # ##### ####### # # # # ### # ### ### ### ##### ####### ##### # # #######
#   #     # #       # # #   # # # #         #     #   # # #     # #     #   # #   #       # #   #   #
# ##### # # ### ######### ##### # # ### ######### # ########### ### ##### ### # ########### # ### # #
#   #   #   #       #         # #   #       # #       #   #     #         #   # #     #     #     # #
# ##### ##### # ##### ### ##### ### # # # ### # # ##### ####### ##### # # ### # # # # # ### ### # # #
#   # # # #   #   #   #       # # # # # # # #   # # #         # #     # #   #   # # #   # #   # # # #
# # # # # # ### ##### # ####### # ### ##### # ##### ##### ### # # ####### # # # # ##### # ### ##### #
# #           # #     #     #   #       #   #           #   #         # # # # #   #       #   #   # #
# ### # # ### # # ####### # # ############# ### ### ######### ### ### # ####### ### ### ### ### ### #
#   # # # #   # #   #     #   #   # # #         #           #   #   # # # # # # # # #   # # # #   # #
### ##### # # ####### ### ##### ### # # ##### ####### ######### ##### # # # # # # ####### # # # # # #
#   #   # # #     # #   #     # #   # # #   #   #           # #     # #     #           # #   # # # #
### ### ### ### ### # # ##### # ### # ##### ########### ### # # # # # ##### ##### # ##### # # # # ###
#   # # #     #   # # # # #   #   #   #       #       # #       # # #   #       # #       # #   # # #
##### # ########### ##### ### # # ### # ### ######### # ### # ######### # # # ##### ### # ######### #
#   #     # # #       # #   #   #   #   #         #     # # # #       # # # #   # # # # #       #   #
### # # ### # # ### ### # ##### # # ####### ### ### ### # ##### ### ### # ####### ### ######### ### #
#     # #     #   #   # #       # #   # #   #         #           # #     #           #       #     #
### ### # # ### # # ### # # # ####### # # ### # ##### ### ##### ##### ### # ### ### ### ### # ### ###
#     #   #   # # #   #   # #     #     # # # # # # # #   #       #     #   #     # #   # # # #     #
#M# # #                 #   # #   #   #       #     #   #   #   # # # #   #               # # #     #
#####################################################################################################
