#################
#               #
# ########### # #
# # #         # #
# # ######### # #
# # #       # # #
# # # ##### # # #
# # # #   # # # #
# # # # % # # # #
# # # #     # # #
# # # ####### # #
# # #           #
# # ######### # #
# #           # #
# ########### # #
#M            # #
#################
