#################################
# # # #                         #
# # # # ####################### #
# # #   #                       #
# # # # # ##################### #
#     # # #       #           # #
### # # # ####### # ######### # #
#   # # # #         #         # #
# ### # # # ##### ### ####### # #
#     # # #         #       # # #
# ##### # # ### ### ####### # # #
#       # # #     # #       # # #
# ####### # # ####### ####### # #
# #       #     #   #         # #
# # ####### # ### # ####### # # #
# #         # #   #         # # #
# # ########### % # #############
# # #       # #   #             #
# # # ##### # ##### # ### ### # #
# #       # #       #         # #
# ####### # ########### # ### # #
#       # # #           #     # #
# ##### # # ################# # #
#     # # # #                   #
# ### # # # # ################# #
#   # # # # #                 # #
### # # # # ################# # #
#     # # #                   # #
# # # # # #######################
# # #   #                       #
# # # # ####################### #
#M# # #                         #
#################################
